wwwwwwwwwwwwwwwwwwwwwwwwwwww
wiiiiiiiiiiiiiiiiiiiiiiiiiiw
w.....__.........___.......w
wtt+++tt+++ttt+t++ttt++ttttw
wll.....l........l......ll.w
w._...._....._.........._..w
w++++++++++++++++++++++++++w
wtt+++tt+++t+tt++t+ttt+++ttw
w...-..........-.......-...w
w...x...x...............xx.w
w++++++++++++++++++++++++++w
wtt+++tt+++++ttt++ttt++ttttw
w._.........._........_....w
w++++++++++++S+++++++++++++w
wwwwwwwwwwwwwwwwwwwwwwwwwwww
