wwwwwwwwwwwwwwwwwwwwwwwwwwww
wiiiiiiiiiiiiiiiiiiiiiiiiiiw
w++t+++t+++++t+++t++++t+++tw
w+ttt+ttt+++ttt+ttt++ttt+ttw
w++t+++t+++++t+++t++++t+++tw
w...x....x.......x.....x...w
w++++++++++++++++++++++++++w
w.-..............-.....-...w
w++t+++t+++++t+++t++++t+++tw
w+ttt+ttt+++ttt+ttt++ttt+ttw
w++t+++t+++++t+++t++++t+++tw
w.-......-................-w
w++++++++++++S+++++++++++++w
wwwwwwwwwwwwwwwwwwwwwwwwwwww
