wwwwwwwwwwwwwwwwwwwwwwwwwwww
wiiiiiiiiiiiiiiiiiiiiiiiiiiw
w+t+t+t+t+t+t+t+tt+t+t+t+t+w
w...l..l.............l.....w
w+t+t+t+t+t+t+t+tt+t+t+t+t+w
w...x....x.......x.....x...w
w+t+t+t+t+t+t+t+tt+t+t+t+t+w
w.-..............-.....-...w
w...x....x.......x.....x...w
w++++++++++++++++++++++++++w
w++t+ttt+tt+tt+ttt+ttt+ttt+w
w.-......-................-w
w++++++++++++S+++++++++++++w
wwwwwwwwwwwwwwwwwwwwwwwwwwww
